!	attention
"	bug
(	(
)	(
,	,
-	as
.	.
143	143
17.	17
1998	1998
34jährigen	34
6	6
?	?
Absatz	6
Alexander	Alexander
All	This
Amtes	Bush
Angebot	compliment
Angelegenheit	My
Arbeitsschutzausschuß	1998
Arbeitsschutzregelungen	does
Art	6
Artikel	143
Attentatsopfern	Kumar
Auf	At
Auskunft	143
Ausrichtungsprogramme	6
Aussetzung	Bush
Aussprache	this
Barentsee	Barents
Bedauern	Lankan
Beginn	That
Begnadigung	Bush
Bericht	report
Berufung	Now
Beschlüsse	Barents
Besuch	Kumar
Betroffene	accused
Bombenexplosionen	aware
Brandschutzbelehrungen	instructions
Brandschutzübung	buildings
Brief	Schroedter
Briefentwurf	Barents
Brüsseler	buildings
Bush	Bush
Bürger	bug
Bürgern	Lankan
Büros	compliment
Cunha-Bericht	6
Dank	you
Das	House
Dennoch	But
Deshalb	get
Dezember	17
Die	34
Diese	Barents
Doch	bug
Dokument	competently
Donnerstag	Thursday
Einfluß	Bush
Einwand	competently
Entschließungen	accused
Ergebnisse	Barents
Ergebnissen	accused
Es	absolutely
Europäischen	European
Evans	Evans
Fakten	facts
Fall	case
Ferien	17
Fernsehen	aware
Fernsehprogrammen	compliment
Fischereipolitik	believe
Flottenverkleinerung	6
Frage	on
Frau	Madam
Freitag	17
Gebäude	air
Gemäß	Bush
Genau	That
George	Bush
Gericht	All
Geschäftsordnung	point
Gorsel	Gorsel
Gouverneur	Bush
Grundlage	Barents
Grundsatz	believe
Grundsatzes	despite
Grundsätzen	This
Gute	17
Haus	If
Herr	Mr
Herrn	Mr
Heute	In
Hicks	34
Hinrichtung	34
Ich	I
Ihnen	you
Ihr	Schroedter
Ihrem	examined
Ihres	Bush
Im	course
Initiative	entirely
Institution	Bush
Ja	entirely
Jahres	compliment
Jahres-	accused
Jahreswechsel	17
Kollegen	In
Kolleginnen	In
Kriminalität	accused
Kräften	Lankan
Kumar	Kumar
Könnten	143
Lanka	Sri
Legislativvorschlag	competently
Linie	Bush
Luftqualität	air
Lynne	Lynne
Länder	6
Ländern	In
Lösung	Lankan
Mal	since
Mannes	34
Meine	My
Millenium-Bug	bug
Mitglieds	At
Mitgliedstaaten	bug
Mittwoch	Gorsel
Monat	Finnish
Monaten	Kumar
Nachrichten	Finnish
Naturkatastrophen	bug
Nichtraucherzonen	areas
Niederländer	Finnish
Nikitin	Alexander
Nun	Now
Nutzen	accused
Opfer	bug
Opfern	In
Parlament	a
Parlaments	Parliament
Parlamentsgebäude	buildings
Petition	At
Plenartagung	accused
Plooij-van	Gorsel
Ponnambalam	very
Position	adopted
Presse	aware
Programm	Finnish
Programme	Barents
Präsidentin	Madam
Präsidentschaftskandidaten	Bush
Punkt	Gorsel
Quotenstrafe	6
Quästoren	Quaestors
Rauchverbot	areas
Recht	All
Rechtsgrundsatz	believe
Rechtsvorschriften	College
Regeln	absolutely
Rußland	Russia
Schande	absolutely
Schreiben	Lankan
Schroedter	Schroedter
Schutz	Barents
Schweigeminute	minute
Segni	Segni
Sender	channel
Sie	you
Sinne	in
Situation	Lankan
Sitzungsperiode	of
Soll	6
Sorge	get
Sprache	My
Sri	Sri
Staaten	34
Staatsanwalt	Now
Stabilität	principle
Strafen	despite
Straßburger	buildings
Stürme	In
Tagen	course
Tagesordnung	Gorsel
Tagung	34
Texas	Texas
Tod	Lankan
Tode	34
Todesurteils	Bush
Toten	aware
Treppen	accident
Umweltinformationen	All
Und	despite
Unfall	accident
Union	European
Unzulässigkeit	143
Verbannung	Finnish
Vereinigten	34
Verlauf	course
Verrat	accused
Verurteilten	Bush
Vielen	Segni
Vollstreckung	Bush
Vorschlag	I
W.	Bush
Wahl	air
Warum	Why
Wenn	If
Wert	College
Weshalb	since
Wie	number
Wiederaufnahme	Resumption
Wir	have
Woche	34
Wort	compliment
Wunsch	,
Wäre	Lankan
Zeit	Kumar
Zimeray	At
Zu	Kumar
Zugang	All
Zusammenhang	143
Zwar	Finnish
aber	because
abgestattet	Kumar
all	Lynne
alle	All
allen	In
alles	Parliament
als	it
am	on
an	that
anderen	Lankan
angebracht	entirely
angeklagt	Now
angemessen	Lankan
ansprechen	That
auch	of
auf	I
auffordern	Lankan
aufmerksam	attention
aus	aware
befassen	6
befaßt	attention
befugt	is
bei	is
beklagen	Kumar
belegt	6
bereit	Schroedter
bereits	At
besteht	course
besten	compliment
betrifft	My
bin	be
bitte	Please
bitten	European
d.	That
dafür	would
damit	shall
dann	to
darauf	College
darstellt	believe
das	,
daß	that
dem	a
den	the
denke	entirely
denn	Finnish
der	the
derartige	be
des	in
deswegen	Barents
deutlich	Russia
die	the
dies	not
diese	of
diesem	air
diesen	believe
dieser	this
dieses	Parliament
diesjährige	34
dort	examined
durchaus	entirely
durchgesetzt	areas
ein	we
eine	.
einem	Lankan
einen	a
einer	minute
eines	been
eingereicht	At
eingespeist	get
eingetreten	bug
einhalten	College
einiger	countries
einverstanden	If
einziges	since
elementaren	believe
empfangen	Finnish
enorm	compliment
entschieden	examined
entspricht	This
entsprochen	But
er	Now
erfüllen	6
erheben	Please
erhebt	(
erkläre	17
erneut	My
erst	Kumar
erste	34
ersten	compliment
ersuchen	get
erweitert	compliment
es	that
europäischen	Barents
falsch	accused
festgelegt	34
festgestellt	accused
feststellen	bug
finden	instructions
finnische	Finnish
folgen	If
französischen	At
freigesprochen	All
freuen	All
friedlichen	Lankan
fällt	34
für	European
gab	Lanka
ganz	Indeed
ganzen	Bush
geben	143
gebeten	Finnish
gedenken	In
gefürchtete	bug
gegen	competently
gehalten	compliment
geht	Now
geltend	Bush
gemacht	All
gemeinsamen	believe
gerade	accused
gerne	shall
gesamten	Bush
geschickt	Finnish
gewaltsamen	Lankan
geworden	bug
großen	College
h.	That
haben	this
halten	absolutely
handelt	competently
hat	Parliament
hatte	had
hatten	17
hier	All
hierher	Finnish
hoffe	hope
hält	does
ich	I
ihn	All
ihr	6
ihrem	Lankan
im	in
immer	has
in	in
insbesondere	In
ist	.
jeden	Finnish
jedoch	Bush
jetzt	Finnish
jungen	34
juristischer	accused
jährlich	6
jüngster	Kumar
kann	Gorsel
keine	instructions
keinen	one
kommen	My
konnten	bug
konstitutionelles	All
können	this
lediglich	competently
legen	College
leider	34
letzten	accused
machen	which
mehrere	aware
mehrjährige	6
meine	believe
meinem	my
mir	the
mit	should
mitteilen	Gorsel
möchte	I
möchten	Finnish
möglich	competently
nach	the
namens	34
neuen	compliment
nicht	not
nichts	accident
niederländischen	Finnish
niederländischer	get
niederländisches	Finnish
noch	buildings
nochmals	once
nun	compliment
nunmehr	Bush
nur	accused
nächsten	course
ob	whether
portugiesischen	Finnish
prüfen	Mrs
recht	Lynne
rechtlich	believe
relativen	principle
sagen	does
schildert	Barents
schrecklichen	bug
schwierigen	Lankan
schöne	17
sehr	his
seinen	accused
seit	since
selbst	adhere
sich	this
sicher	will
sicherer	accident
sie	Lankan
sind	as
so	Lynne
soll	Now
sollen	should
statt	instructions
stattgefunden	buildings
stehende	Lankan
steht	Gorsel
stets	This
ständig	Bush
suchen	Lankan
tatsächlich	compliment
tragen	get
trotz	despite
tun	do
um	one
und	and
uns	it
unseren	compliment
unserer	were
unterbreiten	College
unterbrochene	17
unterlaufen	believe
unternommen	accident
unterzeichnet	At
unzulässig	believe
verabschieden	ourselves
verabschiedet	does
verfolgen	Finnish
vergangenen	accused
verhängt	despite
verschiedenen	In
verteidigt	This
vertreten	with
vertretenen	Bush
verurteilten	34
verweisen	My
vielen	including
vom	Bush
von	the
vor	had
vorliegt	Schroedter
vorschlägt	6
vorzuwerfen	accused
völlig	Lynne
warum	does
weder	buildings
weil	because
wenigen	Kumar
wenn	when
werde	shall
werden	be
wichtigsten	Barents
wie	Finnish
wieder	to
wiederaufgenommen	17
will	Segni
wir	we
wird	a
wirklich	not
wissen	that
wollen	That
worden	been
wurde	been
während	accused
wäre	believe
wünsche	17
würden	Lankan
zahlreichen	aware
zu	.
zum	Parliament
zunächst	compliment
zur	order
zusammen	34
zusammengetreten	1998
zusammenhängenden	Schroedter
zwar	despite
zwei	Finnish
zählt	Kumar
über	report
übermitteln	Lankan
überprüft	air
